0 גלס גלס גלס properName unspecified unspecified unspecified unspecified unspecified  	I_PERS	null
1 , , , punctuation unspecified unspecified unspecified unspecified unspecified  	O	null
2 איתן איתן איתן properName unspecified unspecified unspecified unspecified unspecified  	I_PERS	null

0 ( ( ( punctuation unspecified unspecified unspecified unspecified unspecified  	O	null
1 ###NUMBER### ###NUMBER### ###NUMBER### numeral unspecified unspecified unspecified unspecified unspecified  	I_DATE	null
2 ) ) ) punctuation unspecified unspecified unspecified unspecified unspecified  	O	null

0 משורר משורר משורר noun masculine singular absolute unspecified unspecified  	O	null
1 , , , punctuation unspecified unspecified unspecified unspecified unspecified  	O	null
2 סופר סופר סופר noun masculine singular absolute unspecified unspecified  	O	null
3 ופזמונאי ופזמונאי ופזמונאי adjective masculine singular absolute unspecified unspecified  	O	null

0 נולדה נולד נולדה verb feminine singular unspecified 3 past  	O	null
1 ו ו וגדל conjunction unspecified unspecified unspecified unspecified unspecified 0 
1 גדל גדל וגדל verb masculine singular unspecified 3 past  	O	null
2 ב ב בתל preposition unspecified unspecified unspecified unspecified unspecified 0 
2 תל תל בתל properName unspecified unspecified unspecified unspecified unspecified  	I_LOC	null
3 אביב אביב אביב properName unspecified unspecified unspecified unspecified unspecified  	I_LOC	null
4 . . . punctuation unspecified unspecified unspecified unspecified unspecified  	O	null

0 למד למד למד verb masculine singular unspecified 3 past  	O	null
1 ב ב בתיכון preposition unspecified unspecified unspecified unspecified unspecified 0 
1 ה ה בתיכון definiteArticle unspecified unspecified unspecified unspecified unspecified 0 
1 התיכון תיכון בתיכון noun masculine singular absolute unspecified unspecified  	O	null
2 " " " punctuation unspecified unspecified unspecified unspecified unspecified  	O	null
3 עירוני עירוני עירוני noun masculine singular absolute unspecified unspecified  	O	null
4 ה ה ה definiteArticle unspecified unspecified unspecified unspecified unspecified 0 	O	null
5 ' ' ' punctuation unspecified unspecified unspecified unspecified unspecified  	O	null
6 " " " punctuation unspecified unspecified unspecified unspecified unspecified  	O	null
7 . . . punctuation unspecified unspecified unspecified unspecified unspecified  	O	null

0 שירת שירת שירת verb masculine singular unspecified 3 past  	O	null
1 ב ב בחיל preposition unspecified unspecified unspecified unspecified unspecified 0 
1 חיל חיל בחיל noun masculine singular construct unspecified unspecified  	I_ORG	null
2 ה ה האוויר definiteArticle unspecified unspecified unspecified unspecified unspecified 0 
2 האוויר אוויר האוויר noun masculine singular absolute unspecified unspecified  	I_ORG	null
3 . . . punctuation unspecified unspecified unspecified unspecified unspecified  	O	null

0 יצירות יצירה יצירותיו noun feminine plural absolute unspecified unspecified  
0 ו ו יצירותיו possessive masculine singular unspecified 3 unspecified 0 	O	null
1 התפרסמו התפרסם התפרסמו verb masculine-and-feminine plural unspecified 3 past  	O	null
2 ב ב בכתבי preposition unspecified unspecified unspecified unspecified unspecified 0 
2 כתבי כתב בכתבי noun masculine plural construct unspecified unspecified  	O	null
3 ה ה העת definiteArticle unspecified unspecified unspecified unspecified unspecified 0 
3 העת עת העת noun feminine singular absolute unspecified unspecified  	O	null
4 עתון עיתון עתון noun masculine singular absolute unspecified unspecified  	O	null
5 , , , punctuation unspecified unspecified unspecified unspecified unspecified  	O	null
6 ###NUMBER### ###NUMBER### ###NUMBER### numeral unspecified unspecified unspecified unspecified unspecified  	O	null
7 סימן סימן סימן noun masculine singular absolute unspecified unspecified  	O	null
8 קריאה קריאה קריאה noun feminine singular absolute unspecified unspecified  	O	null
9 ו ו ומסמרים conjunction unspecified unspecified unspecified unspecified unspecified 0 
9 מסמרים מסמר ומסמרים noun masculine plural absolute unspecified unspecified  	O	null
10 . . . punctuation unspecified unspecified unspecified unspecified unspecified  	O	null

0 עבד עבד עבד properName masculine singular unspecified unspecified unspecified  	I_PERS	null
1 כ כ כעיתונאי preposition unspecified unspecified unspecified unspecified unspecified 0 
1 ה ה כעיתונאי definiteArticle unspecified unspecified unspecified unspecified unspecified 0 
1 העיתונאי עיתונאי כעיתונאי noun masculine singular absolute unspecified unspecified  	O	null
2 ו ו ופירסם conjunction unspecified unspecified unspecified unspecified unspecified 0 
2 פירסם פרסם ופירסם verb masculine singular unspecified 3 past  	O	null
3 תחקירים תחקיר תחקירים noun masculine plural absolute unspecified unspecified  	O	null
4 , , , punctuation unspecified unspecified unspecified unspecified unspecified  	O	null
5 רשימות רשימה רשימות noun feminine plural absolute unspecified unspecified  	O	null
6 ו ו וטורי conjunction unspecified unspecified unspecified unspecified unspecified 0 
6 טורי טור וטורי noun masculine plural construct unspecified unspecified  	O	null
7 דעות דעה דעות noun feminine plural absolute unspecified unspecified  	O	null
8 ב ב בעיתונים preposition unspecified unspecified unspecified unspecified unspecified 0 
8 עיתונים עיתון בעיתונים noun masculine plural absolute unspecified unspecified  	O	null
9 ה ה הארץ definiteArticle unspecified unspecified unspecified unspecified unspecified 0 
9 הארץ ארץ הארץ noun feminine singular absolute unspecified unspecified  	O	null
10 , , , punctuation unspecified unspecified unspecified unspecified unspecified  	O	null
11 גלובס גלובס גלובס properName unspecified unspecified unspecified unspecified unspecified  	I_PERS	null
12 , , , punctuation unspecified unspecified unspecified unspecified unspecified  	O	null
13 מקור מקור מקור noun masculine singular construct unspecified unspecified  	I_ORG	null
14 ראשון ראשון ראשון properName unspecified unspecified unspecified unspecified unspecified  	I_ORG	null
15 ו ו ובמקומונים conjunction unspecified unspecified unspecified unspecified unspecified 0 
15 ב ב ובמקומונים preposition unspecified unspecified unspecified unspecified unspecified 0 
15 ה ה ובמקומונים definiteArticle unspecified unspecified unspecified unspecified unspecified 0 
15 המקומונים מקומון ובמקומונים noun masculine plural absolute unspecified unspecified  	O	null
16 עיתון עיתון עיתון noun masculine singular construct unspecified unspecified  	O	null
17 תל תל תל properName unspecified unspecified unspecified unspecified unspecified  	I_LOC	null
18 אביב אביב אביב properName unspecified unspecified unspecified unspecified unspecified  	I_LOC	null
19 , , , punctuation unspecified unspecified unspecified unspecified unspecified  	O	null
20 זמן זמן זמן noun masculine singular construct unspecified unspecified  	O	null
21 תל תל תל properName unspecified unspecified unspecified unspecified unspecified  	I_LOC	null
22 אביב אביב אביב properName unspecified unspecified unspecified unspecified unspecified  	I_LOC	null
23 ו ו והעיר conjunction unspecified unspecified unspecified unspecified unspecified 0 
23 ה ה והעיר definiteArticle unspecified unspecified unspecified unspecified unspecified 0 
23 העיר עיר והעיר noun feminine singular absolute unspecified unspecified  	O	null
24 . . . punctuation unspecified unspecified unspecified unspecified unspecified  	O	null

0 חיבר חיבר חיבר verb masculine singular unspecified 3 past  	O	null
1 פזמונים פזמון פזמונים noun masculine plural absolute unspecified unspecified  	O	null
2 ל ל לרמי preposition unspecified unspecified unspecified unspecified unspecified 0 
2 רמי רמי לרמי properName unspecified unspecified unspecified unspecified unspecified  	I_PERS	null
3 קליינשטיין קליינשטיין קליינשטיין properName unspecified unspecified unspecified unspecified unspecified  	I_PERS	null
4 ( ( ( punctuation unspecified unspecified unspecified unspecified unspecified  	O	null
5 " " " punctuation unspecified unspecified unspecified unspecified unspecified  	O	null
6 תפוחים תפוח תפוחים noun masculine plural absolute unspecified unspecified  	O	null
7 ו ו ותמרים conjunction unspecified unspecified unspecified unspecified unspecified 0 
7 תמרים תמר ותמרים noun masculine plural absolute unspecified unspecified  	O	null
8 " " " punctuation unspecified unspecified unspecified unspecified unspecified  	O	null
9 , , , punctuation unspecified unspecified unspecified unspecified unspecified  	O	null
10 " " " punctuation unspecified unspecified unspecified unspecified unspecified  	O	null
11 חוץ חוץ חוץ noun masculine singular absolute unspecified unspecified  	O	null
12 מן מן ממך preposition unspecified unspecified unspecified unspecified unspecified  
12 ך ך ממך pronomial masculine singular unspecified 2 unspecified 0 	O	null
13 כ כ כלום preposition unspecified unspecified unspecified unspecified unspecified 0 
13 ה ה כלום definiteArticle unspecified unspecified unspecified unspecified unspecified 0 
13 הלום לום כלום noun masculine singular absolute unspecified unspecified  	O	null
14 " " " punctuation unspecified unspecified unspecified unspecified unspecified  	O	null
15 ) ) ) punctuation unspecified unspecified unspecified unspecified unspecified  	O	null
16 , , , punctuation unspecified unspecified unspecified unspecified unspecified  	O	null
17 ריטה ריטה ריטה properName unspecified unspecified unspecified unspecified unspecified  	I_PERS	null
18 ( ( ( punctuation unspecified unspecified unspecified unspecified unspecified  	O	null
19 " " " punctuation unspecified unspecified unspecified unspecified unspecified  	O	null
20 ב ב בערב preposition unspecified unspecified unspecified unspecified unspecified 0 
20 ערב ערב בערב noun masculine singular construct unspecified unspecified  	O	null
21 יום יום יום noun masculine singular construct unspecified unspecified  	I_DATE	null
22 העצמאות עצמאות העצמאות properName unspecified unspecified unspecified unspecified unspecified  	I_DATE	null
23 " " " punctuation unspecified unspecified unspecified unspecified unspecified  	O	null
24 ) ) ) punctuation unspecified unspecified unspecified unspecified unspecified  	O	null
25 , , , punctuation unspecified unspecified unspecified unspecified unspecified  	O	null
26 דיוויד דיויד דיוויד properName unspecified unspecified unspecified unspecified unspecified  	I_PERS	null
27 ברוזה ברוזה ברוזה properName unspecified unspecified unspecified unspecified unspecified  	I_PERS	null
28 ( ( ( punctuation unspecified unspecified unspecified unspecified unspecified  	O	null
29 " " " punctuation unspecified unspecified unspecified unspecified unspecified  	O	null
30 זה זה זה pronoun masculine singular unspecified 3 unspecified  	I_ORG	null
31 ה ה הכול definiteArticle unspecified unspecified unspecified unspecified unspecified 0 
31 הכול כול הכול quantifier unspecified unspecified unspecified unspecified unspecified  	O	null
32 או או או conjunction unspecified unspecified unspecified unspecified unspecified  	O	null
33 כלום כלום כלום pronoun unspecified unspecified unspecified unspecified unspecified  	O	null
34 " " " punctuation unspecified unspecified unspecified unspecified unspecified  	O	null
35 ) ) ) punctuation unspecified unspecified unspecified unspecified unspecified  	O	null
36 ו ו ואחרים conjunction unspecified unspecified unspecified unspecified unspecified 0 
36 אחרים אחר ואחרים adjective masculine plural absolute unspecified unspecified  	O	null
37 , , , punctuation unspecified unspecified unspecified unspecified unspecified  	O	null
38 מן מן מהם preposition unspecified unspecified unspecified unspecified unspecified  
38 הם הם מהם pronomial masculine plural unspecified 3 unspecified 0 	O	null
39 ש ש שזכו relativizer/subordinatingConjunction unspecified unspecified unspecified unspecified unspecified 0 
39 זכו זכה שזכו verb masculine-and-feminine plural unspecified 3 past  	O	null
40 ל ל לפופולריות preposition unspecified unspecified unspecified unspecified unspecified 0 
40 פופולריות פופולריות לפופולריות noun feminine singular absolute unspecified unspecified  	O	null
41 רבה רב רבה adjective feminine singular absolute unspecified unspecified  	O	null
42 . . . punctuation unspecified unspecified unspecified unspecified unspecified  	O	null

0 ל ל לצד preposition unspecified unspecified unspecified unspecified unspecified 0 
0 צד צד לצד noun masculine singular construct unspecified unspecified  	O	null
1 ה ה הכתיבה definiteArticle unspecified unspecified unspecified unspecified unspecified 0 
1 הכתיבה כתיבה הכתיבה noun feminine singular absolute unspecified unspecified  	O	null
2 הגיש הגיש הגיש verb masculine singular unspecified 3 past  	O	null
3 את את את at-preposition unspecified unspecified unspecified unspecified unspecified  	O	null
4 תוכנית תוכנייה תוכנית noun feminine singular construct unspecified unspecified  	O	null
5 ה ה הרדיו definiteArticle unspecified unspecified unspecified unspecified unspecified 0 
5 הרדיו רדיו הרדיו noun masculine singular absolute unspecified unspecified  	O	null
6 ציפורי ציפור ציפורי noun masculine plural construct unspecified unspecified  	O	null
7 לילה לילה לילה noun masculine singular absolute unspecified unspecified  	O	null
8 ב ב ב preposition unspecified unspecified unspecified unspecified unspecified 0 	I_ORG	null
9 " " " punctuation unspecified unspecified unspecified unspecified unspecified  	I_ORG	null
10 גלי גל גלי properName unspecified unspecified unspecified unspecified unspecified  	I_ORG	null
11 צה"ל צה"ל צה"ל properName unspecified unspecified unspecified unspecified unspecified  	I_ORG	null
12 " " " punctuation unspecified unspecified unspecified unspecified unspecified  	O	null
13 ו ו ותוכנית conjunction unspecified unspecified unspecified unspecified unspecified 0 
13 תוכנית תוכנית ותוכנית noun feminine singular absolute unspecified unspecified  	O	null
14 אישית אישי אישית adjective feminine singular absolute unspecified unspecified  	O	null
15 ב ב ברדיו preposition unspecified unspecified unspecified unspecified unspecified 0 
15 ה ה ברדיו definiteArticle unspecified unspecified unspecified unspecified unspecified 0 
15 הרדיו רדיו ברדיו noun masculine singular absolute unspecified unspecified  	O	null
16 ה ה האזורי definiteArticle unspecified unspecified unspecified unspecified unspecified 0 
16 האזורי אזורי האזורי adjective masculine singular absolute unspecified unspecified  	O	null
17 של של של shel-preposition unspecified unspecified unspecified unspecified unspecified  	O	null
18 ירושלים ירושלים ירושלים properName unspecified unspecified unspecified unspecified unspecified  	I_LOC	null
19 . . . punctuation unspecified unspecified unspecified unspecified unspecified  	O	null

0 כמו כמו כמו conjunction unspecified unspecified unspecified unspecified unspecified  	O	null
1 כן כן כן conjunction unspecified unspecified unspecified unspecified unspecified  	O	null
2 השתתף השתתף השתתף verb masculine singular unspecified 3 past  	O	null
3 כ כ כשחקן preposition unspecified unspecified unspecified unspecified unspecified 0 
3 שחקן שחקן כשחקן noun masculine singular absolute unspecified unspecified  	O	null
4 ב ב בסרטים preposition unspecified unspecified unspecified unspecified unspecified 0 
4 סרטים סרט בסרטים noun masculine plural absolute unspecified unspecified  	O	null
5 ו ו ובסדרות conjunction unspecified unspecified unspecified unspecified unspecified 0 
5 ב ב ובסדרות preposition unspecified unspecified unspecified unspecified unspecified 0 
5 סדרות סדרה ובסדרות noun feminine plural absolute unspecified unspecified  	O	null
6 טלוויזיה טלוויזיה טלוויזיה noun feminine singular absolute unspecified unspecified  	O	null
7 . . . punctuation unspecified unspecified unspecified unspecified unspecified  	O	null

0 עובד עובד עובד noun masculine singular absolute unspecified unspecified  	O	null
1 ב ב במשרד preposition unspecified unspecified unspecified unspecified unspecified 0 
1 משרד משרד במשרד noun masculine singular construct unspecified unspecified  	O	null
2 פרסום פרסום פרסום noun masculine singular absolute unspecified unspecified  	O	null
3 . . . punctuation unspecified unspecified unspecified unspecified unspecified  	O	null

0 מתגורר התגורר מתגורר verb masculine singular unspecified any beinoni  	I_LOC	null
1 ב ב בבת preposition unspecified unspecified unspecified unspecified unspecified 0 
1 בת בת בבת noun feminine singular construct unspecified unspecified  	I_LOC	null
2 ים ים ים properName unspecified unspecified unspecified unspecified unspecified  	I_LOC	null
3 . . . punctuation unspecified unspecified unspecified unspecified unspecified  	O	null

0 שירי שיר שיריו noun masculine plural absolute unspecified unspecified  
0 ו ו שיריו possessive masculine singular unspecified 3 unspecified 0 	O	null
1 ה ה הראשונים definiteArticle unspecified unspecified unspecified unspecified unspecified 0 
1 הראשונים ראשונים הראשונים noun masculine plural absolute unspecified unspecified  	O	null
2 התפרסמו התפרסם התפרסמו verb masculine-and-feminine plural unspecified 3 past  	O	null
3 ב ב בעתון preposition unspecified unspecified unspecified unspecified unspecified 0 
3 עתון עיתון בעתון noun masculine singular construct unspecified unspecified  	O	null
4 ###NUMBER### ###NUMBER### ###NUMBER### numeral unspecified unspecified unspecified unspecified unspecified  	O	null
5 ) ) ) punctuation unspecified unspecified unspecified unspecified unspecified  	O	null
6 . . . punctuation unspecified unspecified unspecified unspecified unspecified  	O	null
7 ###NUMBER### ###NUMBER### ###NUMBER### numeral unspecified unspecified unspecified unspecified unspecified  	I_ORG	null
8 ספר ספר ספר noun masculine singular absolute unspecified unspecified  	O	null
9 שירי שיר שיריו noun masculine plural absolute unspecified unspecified  
9 ו ו שיריו possessive masculine singular unspecified 3 unspecified 0 	O	null
10 ה ה הראשון definiteArticle unspecified unspecified unspecified unspecified unspecified 0 
10 הראשון ORD1 הראשון numeral masculine singular absolute unspecified unspecified  	O	null
11 , , , punctuation unspecified unspecified unspecified unspecified unspecified  	O	null
12 אני הוא אני pronoun masculine-and-feminine singular unspecified 1 unspecified  	O	null
13 סימון סימון סימון properName unspecified unspecified unspecified unspecified unspecified  	I_PERS	null
14 נחמיאס נחמיאס נחמיאס properName unspecified unspecified unspecified unspecified unspecified  	I_PERS	null
15 ( ( ( punctuation unspecified unspecified unspecified unspecified unspecified  	O	null
16 ה ה הקיבוץ definiteArticle unspecified unspecified unspecified unspecified unspecified 0 
16 הקיבוץ קיבוץ הקיבוץ noun masculine singular absolute unspecified unspecified  	O	null
17 ה ה המאוחד definiteArticle unspecified unspecified unspecified unspecified unspecified 0 
17 המאוחד מאוחד המאוחד adjective masculine singular absolute unspecified unspecified  	O	null
18 , , , punctuation unspecified unspecified unspecified unspecified unspecified  	O	null
19 ) ) ) punctuation unspecified unspecified unspecified unspecified unspecified  	O	null
20 , , , punctuation unspecified unspecified unspecified unspecified unspecified  	O	null
21 ###NUMBER### ###NUMBER### ###NUMBER### numeral unspecified unspecified unspecified unspecified unspecified  	I_DATE	null
22 מאופיין אופיין מאופיין verb masculine singular unspecified any beinoni  	O	null
23 ב ב בערב preposition unspecified unspecified unspecified unspecified unspecified 0 
23 ערב ערב בערב noun masculine singular absolute unspecified unspecified  	O	null
24 רב רב רב adjective masculine singular absolute unspecified unspecified  	O	null
25 של של של shel-preposition unspecified unspecified unspecified unspecified unspecified  	O	null
26 קולות קול קולות noun masculine plural absolute unspecified unspecified  	O	null
27 , , , punctuation unspecified unspecified unspecified unspecified unspecified  	O	null
28 ב ב בחוסר preposition unspecified unspecified unspecified unspecified unspecified 0 
28 חוסר חוסר בחוסר noun masculine singular construct unspecified unspecified  	O	null
29 עקביות עקביות עקביות noun feminine singular absolute unspecified unspecified  	O	null
30 מילולית מילולי מילולית adjective feminine singular absolute unspecified unspecified  	O	null
31 מכוון מכוון מכוון adjective masculine singular absolute unspecified unspecified  	O	null
32 ו ו ובלשון conjunction unspecified unspecified unspecified unspecified unspecified 0 
32 ב ב ובלשון preposition unspecified unspecified unspecified unspecified unspecified 0 
32 לשון לשון ובלשון noun feminine singular absolute unspecified unspecified  	O	null
33 דיבורית דיבורי דיבורית adjective feminine singular absolute unspecified unspecified  	O	null
34 משובשת משובש משובשת adjective feminine singular absolute unspecified unspecified  	O	null
35 לפרקים לפרקים לפרקים adverb unspecified unspecified unspecified unspecified unspecified  	O	null
36 , , , punctuation unspecified unspecified unspecified unspecified unspecified  	O	null
37 ה ה המפנה definiteArticle unspecified unspecified unspecified unspecified unspecified 0 
37 המפנה מפנה המפנה noun masculine singular absolute unspecified unspecified  	O	null
38 עורף עורף עורף noun masculine singular absolute unspecified unspecified  	O	null
39 ל ל לפואטיקה preposition unspecified unspecified unspecified unspecified unspecified 0 
39 ה ה לפואטיקה definiteArticle unspecified unspecified unspecified unspecified unspecified 0 
39 הפואטיקה הפואטיקה לפואטיקה noun feminine singular absolute unspecified unspecified  	O	null
40 ה ה השירית definiteArticle unspecified unspecified unspecified unspecified unspecified 0 
40 השירית שירי השירית adjective feminine singular absolute unspecified unspecified  	O	null
41 ה ה המקובלת definiteArticle unspecified unspecified unspecified unspecified unspecified 0 
41 המקובלת מקובל המקובלת adjective feminine singular absolute unspecified unspecified  	O	null
42 . . . punctuation unspecified unspecified unspecified unspecified unspecified  	O	null

0 ב ב בשילוב preposition unspecified unspecified unspecified unspecified unspecified 0 
0 שילוב שילוב בשילוב noun masculine singular absolute unspecified unspecified  	O	null
1 בין בין בין preposition unspecified unspecified unspecified unspecified unspecified  	O	null
2 עברית עברית עברית properName feminine singular unspecified unspecified unspecified  	I_PERS	null
3 , , , punctuation unspecified unspecified unspecified unspecified unspecified  	O	null
4 לדינו לדינו לדינו properName unspecified unspecified unspecified unspecified unspecified  	I_PERS	null
5 , , , punctuation unspecified unspecified unspecified unspecified unspecified  	O	null
6 יידיש יידיש יידיש properName unspecified unspecified unspecified unspecified unspecified  	I_PERS	null
7 ו ו וערבית conjunction unspecified unspecified unspecified unspecified unspecified 0 
7 ערבית ערבי וערבית adjective feminine singular absolute unspecified unspecified  	O	null
8 משמש משמש משמש verb masculine singular unspecified 3 past  	O	null
9 ה ה הדובר definiteArticle unspecified unspecified unspecified unspecified unspecified 0 
9 הדובר דובר הדובר noun masculine singular absolute unspecified unspecified  	O	null
10 ה ה האותנטי definiteArticle unspecified unspecified unspecified unspecified unspecified 0 
10 האותנטי אותנטי האותנטי adjective masculine singular absolute unspecified unspecified  	O	null
11 פה פה פה adverb unspecified unspecified unspecified unspecified unspecified  	O	null
12 ל ל למגזר preposition unspecified unspecified unspecified unspecified unspecified 0 
12 ה ה למגזר definiteArticle unspecified unspecified unspecified unspecified unspecified 0 
12 המגזר מגזר למגזר noun masculine singular absolute unspecified unspecified  	O	null
13 ה ה הדחויים definiteArticle unspecified unspecified unspecified unspecified unspecified 0 
13 הדחויים דחוי הדחויים adjective masculine plural absolute unspecified unspecified  	O	null
14 ש ש שבשולי relativizer/subordinatingConjunction unspecified unspecified unspecified unspecified unspecified 0 
14 ב ב שבשולי preposition unspecified unspecified unspecified unspecified unspecified 0 
14 שולי שול שבשולי noun masculine plural construct unspecified unspecified  	O	null
15 ה ה התרבות definiteArticle unspecified unspecified unspecified unspecified unspecified 0 
15 התרבות תרבות התרבות noun feminine singular absolute unspecified unspecified  	O	null
16 ה ה הישראלית definiteArticle unspecified unspecified unspecified unspecified unspecified 0 
16 הישראלית ישראלי הישראלית adjective feminine singular absolute unspecified unspecified  	O	null
17 - - - punctuation unspecified unspecified unspecified unspecified unspecified  	O	null
18 ציונית ציוני ציונית adjective feminine singular absolute unspecified unspecified  	O	null
19 . . . punctuation unspecified unspecified unspecified unspecified unspecified  	O	null

0 ה ה הספר definiteArticle unspecified unspecified unspecified unspecified unspecified 0 
0 הספר ספר הספר noun masculine singular absolute unspecified unspecified  	O	null
1 נפתח נפתח נפתח verb masculine singular unspecified 3 past  	O	null
2 ב ב בהצהרת preposition unspecified unspecified unspecified unspecified unspecified 0 
2 הצהרת הצהרה בהצהרת noun feminine singular construct unspecified unspecified  	O	null
3 ה ה המשורר definiteArticle unspecified unspecified unspecified unspecified unspecified 0 
3 המשורר משורר המשורר noun masculine singular absolute unspecified unspecified  	O	null
4 ה ה המבקש definiteArticle unspecified unspecified unspecified unspecified unspecified 0 
4 המבקש מבקש המבקש noun masculine singular absolute unspecified unspecified  	O	null
5 להפוך הפך להפוך verb unspecified unspecified unspecified unspecified infinitive  	O	null
6 את את את at-preposition unspecified unspecified unspecified unspecified unspecified  	O	null
7 השירה השיר השירה verb feminine singular unspecified 3 past  	O	null
8 נגישה נגיש נגישה adjective feminine singular absolute unspecified unspecified  	O	null
9 ל ל לכול preposition unspecified unspecified unspecified unspecified unspecified 0 
9 כול כול לכול quantifier unspecified unspecified construct unspecified unspecified  	O	null
10 , , , punctuation unspecified unspecified unspecified unspecified unspecified  	O	null
11 כ כ כחלק preposition unspecified unspecified unspecified unspecified unspecified 0 
11 חלק חלק כחלק noun masculine singular construct unspecified unspecified  	O	null
12 מ מ מהיומיום preposition unspecified unspecified unspecified unspecified unspecified 0 
12 ה ה מהיומיום definiteArticle unspecified unspecified unspecified unspecified unspecified 0 
12 היומיום היומיום מהיומיום noun masculine singular absolute unspecified unspecified  	O	null
13 : : : punctuation unspecified unspecified unspecified unspecified unspecified  	O	null
14 " " " punctuation unspecified unspecified unspecified unspecified unspecified  	O	null
15 הָיִיתִי הָיִיתִי הָיִיתִי adverb unspecified unspecified unspecified unspecified unspecified  	O	null
16 רוֹצֶה רוֹצֶה רוֹצֶה properName unspecified unspecified unspecified unspecified unspecified  	I_PERS	null
17 שֶׁשִּׁירַי שֶׁשִּׁירַי שֶׁשִּׁירַי properName unspecified unspecified unspecified unspecified unspecified  	I_PERS	null
18 יְפֻרְסְמו יְפֻרְסְמו יְפֻרְסְמו properName unspecified unspecified unspecified unspecified unspecified  	I_PERS	null
19 ּ ּ ּ punctuation unspecified unspecified unspecified unspecified unspecified  	O	null
20 עַל עַל עַל properName unspecified unspecified unspecified unspecified unspecified  	I_PERS	null
21 ל ל לוּחוֹת preposition unspecified unspecified unspecified unspecified unspecified 0 
21 ה ה לוּחוֹת definiteArticle unspecified unspecified unspecified unspecified unspecified 0 
21 הוּחוֹת הוּחוֹת לוּחוֹת noun feminine singular absolute unspecified unspecified  	O	null
22 הַמּוֹדָעוֹת הַמּוֹדָעוֹת הַמּוֹדָעוֹת properName unspecified unspecified unspecified unspecified unspecified  	I_PERS	null
23 / / / punctuation unspecified unspecified unspecified unspecified unspecified  	O	null
24 ש ש שֶׁל relativizer/subordinatingConjunction unspecified unspecified unspecified unspecified unspecified 0 
24 ֶׁל ֶׁל שֶׁל noun masculine singular absolute unspecified unspecified  	O	null
25 ה ה הַסְּרָטִים definiteArticle unspecified unspecified unspecified unspecified unspecified 0 
25 הַסְּרָטִים הַסְּרָטִים הַסְּרָטִים noun feminine singular absolute unspecified unspecified  	O	null
26 הַחֲדָשִׁים הַחֲדָשִׁים הַחֲדָשִׁים properName unspecified unspecified unspecified unspecified unspecified  	I_PERS	null
27 וְהַהַצָּגוֹת וְהַהַצָּגוֹת וְהַהַצָּגוֹת properName unspecified unspecified unspecified unspecified unspecified  	I_PERS	null
28 [ [ [ punctuation unspecified unspecified unspecified unspecified unspecified  	O	null
29 ... ... ... punctuation unspecified unspecified unspecified unspecified unspecified  	O	null
30 ] ] ] punctuation unspecified unspecified unspecified unspecified unspecified  	O	null
31 " " " punctuation unspecified unspecified unspecified unspecified unspecified  	O	null
32 ( ( ( punctuation unspecified unspecified unspecified unspecified unspecified  	O	null
33 " " " punctuation unspecified unspecified unspecified unspecified unspecified  	O	null
34 מה מה מה interrogative unspecified unspecified unspecified unspecified unspecified  	O	null
35 אני הוא אני pronoun masculine-and-feminine singular unspecified 1 unspecified  	O	null
36 רוצה רצה רוצה verb feminine singular unspecified any beinoni  	O	null
37 " " " punctuation unspecified unspecified unspecified unspecified unspecified  	O	null
38 ) ) ) punctuation unspecified unspecified unspecified unspecified unspecified  	O	null
39 . . . punctuation unspecified unspecified unspecified unspecified unspecified  	O	null

0 סימון סימון סימון properName unspecified unspecified unspecified unspecified unspecified  	I_PERS	null
1 נחמיאס נחמיאס נחמיאס properName unspecified unspecified unspecified unspecified unspecified  	I_PERS	null
2 הוא הוא הוא pronoun masculine singular unspecified 3 unspecified  	O	null
3 דובר דובר דובר noun masculine singular construct unspecified unspecified  	O	null
4 פיקטיבי פיקטיבי פיקטיבי adjective masculine singular absolute unspecified unspecified  	O	null
5 , , , punctuation unspecified unspecified unspecified unspecified unspecified  	O	null
6 ה ה המשמיע definiteArticle unspecified unspecified unspecified unspecified unspecified 0 
6 המשמיע השמיע המשמיע participle masculine singular absolute any unspecified  	O	null
7 קול קול קול noun masculine singular construct unspecified unspecified  	O	null
8 ש ש שנון relativizer/subordinatingConjunction unspecified unspecified unspecified unspecified unspecified 0 
8 נון נון שנון properName unspecified unspecified unspecified unspecified unspecified  	I_PERS	null
9 ו ו והומוריסטי conjunction unspecified unspecified unspecified unspecified unspecified 0 
9 הומוריסטי הומוריסט והומוריסטי noun masculine plural construct unspecified unspecified  	O	null
10 , , , punctuation unspecified unspecified unspecified unspecified unspecified  	O	null
11 ה ה המשמש definiteArticle unspecified unspecified unspecified unspecified unspecified 0 
11 המשמש משמש המשמש noun masculine singular absolute unspecified unspecified  	O	null
12 ל ל לעתים preposition unspecified unspecified unspecified unspecified unspecified 0 
12 ה ה לעתים definiteArticle unspecified unspecified unspecified unspecified unspecified 0 
12 העתים עת לעתים noun feminine plural absolute unspecified unspecified  	O	null
13 ל ל לתיעוד preposition unspecified unspecified unspecified unspecified unspecified 0 
13 תיעוד תיעוד לתיעוד noun masculine singular construct unspecified unspecified  	O	null
14 חוויות חוויה חוויות noun feminine plural construct unspecified unspecified  	O	null
15 ה ה היומיום definiteArticle unspecified unspecified unspecified unspecified unspecified 0 
15 היומיום היומיום היומיום noun masculine singular absolute unspecified unspecified  	O	null
16 ו ו ולעתים conjunction unspecified unspecified unspecified unspecified unspecified 0 
16 ל ל ולעתים preposition unspecified unspecified unspecified unspecified unspecified 0 
16 ה ה ולעתים definiteArticle unspecified unspecified unspecified unspecified unspecified 0 
16 העתים עת ולעתים noun feminine plural absolute unspecified unspecified  	O	null
17 אוחז אחז אוחז participle masculine singular absolute any unspecified  	O	null
18 ב ב בשופר preposition unspecified unspecified unspecified unspecified unspecified 0 
18 שופר שופר בשופר noun masculine singular construct unspecified unspecified  	O	null
19 ה ה המחאה definiteArticle unspecified unspecified unspecified unspecified unspecified 0 
19 המחאה מחאה המחאה noun feminine singular absolute unspecified unspecified  	O	null
20 ב ב בנימה preposition unspecified unspecified unspecified unspecified unspecified 0 
20 ה ה בנימה definiteArticle unspecified unspecified unspecified unspecified unspecified 0 
20 הנימה נימה בנימה noun feminine singular absolute unspecified unspecified  	O	null
21 ה ה המשלבת definiteArticle unspecified unspecified unspecified unspecified unspecified 0 
21 המשלבת שילב המשלבת participle feminine singular absolute any unspecified  	O	null
22 זעם זעם זעם noun masculine singular construct unspecified unspecified  	O	null
23 ו ו ורכות conjunction unspecified unspecified unspecified unspecified unspecified 0 
23 רכות רך ורכות adjective feminine plural absolute unspecified unspecified  	O	null
24 , , , punctuation unspecified unspecified unspecified unspecified unspecified  	O	null
25 כמו כמו כמו conjunction unspecified unspecified unspecified unspecified unspecified  	O	null
26 " " " punctuation unspecified unspecified unspecified unspecified unspecified  	O	null
27 הַמְּשׁוֹרֵר הַמְּשׁוֹרֵר הַמְּשׁוֹרֵר properName unspecified unspecified unspecified unspecified unspecified  	I_ORG	null
28 ה ה הַלְּאֻמִּי definiteArticle unspecified unspecified unspecified unspecified unspecified 0 
28 הַלְּאֻמִּי הַלְּאֻמִּי הַלְּאֻמִּי adjective masculine singular absolute unspecified unspecified  	O	null
29 ש ש שֶׁל relativizer/subordinatingConjunction unspecified unspecified unspecified unspecified unspecified 0 
29 ֶׁל ֶׁל שֶׁל noun masculine singular absolute unspecified unspecified  	O	null
30 הָאַשְׁכְּנַזִּים הָאַשְׁכְּנַזִּים הָאַשְׁכְּנַזִּים noun masculine singular construct unspecified unspecified  	O	null
31 / / / punctuation unspecified unspecified unspecified unspecified unspecified  	O	null
32 חַיִּים חַיִּים חַיִּים noun masculine plural absolute unspecified unspecified  	O	null
33 נַחְמָן נַחְמָן נַחְמָן noun masculine singular construct unspecified unspecified  	O	null
34 ב ב בְּיַאלִיק preposition unspecified unspecified unspecified unspecified unspecified 0 
34 ה ה בְּיַאלִיק definiteArticle unspecified unspecified unspecified unspecified unspecified 0 
34 הְּיַאלִיק הְּיַאלִיק בְּיַאלִיק noun masculine singular absolute unspecified unspecified  	O	null
35 ש ש שָׂנָא relativizer/subordinatingConjunction unspecified unspecified unspecified unspecified unspecified 0 
35 ָׂנָא ָׂנָא שָׂנָא noun masculine singular construct unspecified unspecified  	O	null
36 אוֹתָנו אוֹתָנו אוֹתָנו properName unspecified unspecified unspecified unspecified unspecified  	I_ORG	null
37 ּ ּ ּ punctuation unspecified unspecified unspecified unspecified unspecified  	O	null
38 / / / punctuation unspecified unspecified unspecified unspecified unspecified  	O	null
39 אֶת אֶת אֶת properName unspecified unspecified unspecified unspecified unspecified  	I_PERS	null
40 הַשְּׁחׂרִים הַשְּׁחׂרִים הַשְּׁחׂרִים verb masculine singular unspecified 3 past  	O	null
41 [ [ [ punctuation unspecified unspecified unspecified unspecified unspecified  	O	null
42 ... ... ... punctuation unspecified unspecified unspecified unspecified unspecified  	O	null
43 ] ] ] punctuation unspecified unspecified unspecified unspecified unspecified  	O	null
44 / / / punctuation unspecified unspecified unspecified unspecified unspecified  	O	null
45 מ מ מַה preposition unspecified unspecified unspecified unspecified unspecified 0 
45 ַה ַה מַה properName unspecified unspecified unspecified unspecified unspecified  	I_PERS	null
46 ל ל לַּעֲשׂוֹת preposition unspecified unspecified unspecified unspecified unspecified 0 
46 ַּעֲשׂוֹת ַּעֲשׂוֹת לַּעֲשׂוֹת properName unspecified unspecified unspecified unspecified unspecified  	I_PERS	null
47 , , , punctuation unspecified unspecified unspecified unspecified unspecified  	O	null
48 וַאֲנִי וַאֲנִי וַאֲנִי noun masculine singular absolute unspecified unspecified  	O	null
49 אוֹהֵב אוֹהֵב אוֹהֵב properName unspecified unspecified unspecified unspecified unspecified  	I_PERS	null
50 אֶת אֶת אֶת properName unspecified unspecified unspecified unspecified unspecified  	I_PERS	null
51 שִׁירָיו שִׁירָיו שִׁירָיו properName unspecified unspecified unspecified unspecified unspecified  	I_PERS	null
52 / / / punctuation unspecified unspecified unspecified unspecified unspecified  	O	null
53 [ [ [ punctuation unspecified unspecified unspecified unspecified unspecified  	O	null
54 ... ... ... punctuation unspecified unspecified unspecified unspecified unspecified  	O	null
55 ] ] ] punctuation unspecified unspecified unspecified unspecified unspecified  	O	null
56 הַכְנִיסֵנִי הַכְנִיסֵנִי הַכְנִיסֵנִי noun masculine singular absolute unspecified unspecified  	O	null
57 תַּחַת תַּחַת תַּחַת noun feminine singular construct unspecified unspecified  	O	null
58 כְּנָפְך כְּנָפְך כְּנָפְך properName unspecified unspecified unspecified unspecified unspecified  	I_ORG	null
59 ָ ָ ָ punctuation unspecified unspecified unspecified unspecified unspecified  	O	null
60 , , , punctuation unspecified unspecified unspecified unspecified unspecified  	I_LOC	null
61 ב ב בֶּן preposition unspecified unspecified unspecified unspecified unspecified 0 
61 ֶּן ֶּן בֶּן properName unspecified unspecified unspecified unspecified unspecified  	I_LOC	null
62 - - - punctuation unspecified unspecified unspecified unspecified unspecified  	O	null
63 ש ש שַׁרְמוּטָה relativizer/subordinatingConjunction unspecified unspecified unspecified unspecified unspecified 0 
63 ַׁרְמוּטָה ַׁרְמוּטָה שַׁרְמוּטָה noun feminine singular absolute unspecified unspecified  	O	null
64 ! ! ! punctuation unspecified unspecified unspecified unspecified unspecified  	O	null
65 " " " punctuation unspecified unspecified unspecified unspecified unspecified  	O	null
66 ( ( ( punctuation unspecified unspecified unspecified unspecified unspecified  	O	null
67 ללא ללא ללא preposition unspecified unspecified unspecified unspecified unspecified  	O	null
68 כותרת כותרת כותרת noun feminine singular construct unspecified unspecified  	O	null
69 ) ) ) punctuation unspecified unspecified unspecified unspecified unspecified  	O	null
70 . . . punctuation unspecified unspecified unspecified unspecified unspecified  	O	null

0 שבע שבע שבע adjective masculine singular absolute unspecified unspecified  	O	null
1 - - - punctuation unspecified unspecified unspecified unspecified unspecified  	O	null
2 עשרה CARD10 עשרה numeral masculine plural absolute unspecified unspecified  	O	null
3 שנים שנה שנים noun feminine plural absolute unspecified unspecified  	O	null
4 אחרי אחרי אחרי preposition unspecified unspecified unspecified unspecified unspecified  	O	null
5 אני אני אני noun masculine singular absolute unspecified unspecified  	O	null
6 סימון סימון סימון properName unspecified unspecified unspecified unspecified unspecified  	I_PERS	null
7 נחמיאס נחמיאס נחמיאס properName unspecified unspecified unspecified unspecified unspecified  	I_PERS	null
8 פירסם פרסם פירסם verb masculine singular unspecified 3 past  	O	null
9 גלס גלס גלס properName unspecified unspecified unspecified unspecified unspecified  	I_PERS	null
10 את את את at-preposition unspecified unspecified unspecified unspecified unspecified  	O	null
11 אופרות אופרה אופרות noun feminine plural absolute unspecified unspecified  	O	null
12 ב ב בחמסין preposition unspecified unspecified unspecified unspecified unspecified 0 
12 חמסין חמסין בחמסין noun masculine singular absolute unspecified unspecified  	O	null
13 ) ) ) punctuation unspecified unspecified unspecified unspecified unspecified  	O	null
14 , , , punctuation unspecified unspecified unspecified unspecified unspecified  	O	null
15 ###NUMBER### ###NUMBER### ###NUMBER### numeral unspecified unspecified unspecified unspecified unspecified  	I_DATE	null
16 קובץ קובץ קובץ noun masculine singular construct unspecified unspecified  	O	null
17 ב ב בן preposition unspecified unspecified unspecified unspecified unspecified  
17 הן הן בן pronomial feminine plural unspecified 3 unspecified 0 	O	null
18 עשרה CARD10 עשרה numeral masculine plural absolute unspecified unspecified  	O	null
19 סיפורים סיפור סיפורים noun masculine plural absolute unspecified unspecified  	O	null
20 ה ה הכתובים definiteArticle unspecified unspecified unspecified unspecified unspecified 0 
20 הכתובים כתב הכתובים participle masculine plural absolute any unspecified  	O	null
21 ב ב בלשון preposition unspecified unspecified unspecified unspecified unspecified 0 
21 לשון לשון בלשון noun feminine singular absolute unspecified unspecified  	O	null
22 ציורית ציורי ציורית adjective feminine singular absolute unspecified unspecified  	O	null
23 עשירה עשיר עשירה adjective feminine singular absolute unspecified unspecified  	O	null
24 , , , punctuation unspecified unspecified unspecified unspecified unspecified  	O	null
25 ה ה החושפת definiteArticle unspecified unspecified unspecified unspecified unspecified 0 
25 החושפת חשף החושפת participle feminine singular absolute any unspecified  	O	null
26 את את את at-preposition unspecified unspecified unspecified unspecified unspecified  	O	null
27 עולם עולם עולמם noun masculine singular absolute unspecified unspecified  
27 ם ם עולמם possessive masculine plural unspecified 3 unspecified 0 	O	null
28 ה ה המתרוקן definiteArticle unspecified unspecified unspecified unspecified unspecified 0 
28 המתרוקן התרוקן המתרוקן participle masculine singular absolute any unspecified  	O	null
29 של של של shel-preposition unspecified unspecified unspecified unspecified unspecified  	O	null
30 אנשים איש אנשים noun masculine plural absolute unspecified unspecified  	O	null
31 מבוגרים מבוגר מבוגרים adjective masculine plural absolute unspecified unspecified  	O	null
32 ה ה החווים definiteArticle unspecified unspecified unspecified unspecified unspecified 0 
32 החווים חווה החווים participle masculine plural absolute any unspecified  	O	null
33 את את את at-preposition unspecified unspecified unspecified unspecified unspecified  	O	null
34 עליבות עליבות עליבות noun feminine singular construct unspecified unspecified  	O	null
35 ה ה הזקנה definiteArticle unspecified unspecified unspecified unspecified unspecified 0 
35 הזקנה זקנה הזקנה noun feminine singular absolute unspecified unspecified  	O	null
36 ו ו ואת conjunction unspecified unspecified unspecified unspecified unspecified 0 
36 את את ואת at-preposition unspecified unspecified unspecified unspecified unspecified  	O	null
37 עלבון עלבון עלבון noun masculine singular construct unspecified unspecified  	O	null
38 ה ה העוני definiteArticle unspecified unspecified unspecified unspecified unspecified 0 
38 העוני עוני העוני noun masculine singular absolute unspecified unspecified  	O	null
39 . . . punctuation unspecified unspecified unspecified unspecified unspecified  	O	null

0 ב ב במרכזם preposition unspecified unspecified unspecified unspecified unspecified 0 
0 מרכז מרכז במרכזם noun masculine singular absolute unspecified unspecified  
0 ם ם במרכזם possessive masculine plural unspecified 3 unspecified 0 	O	null
1 עיסוק עיסוק עיסוק noun masculine singular absolute unspecified unspecified  	O	null
2 ב ב בזהות preposition unspecified unspecified unspecified unspecified unspecified 0 
2 ה ה בזהות definiteArticle unspecified unspecified unspecified unspecified unspecified 0 
2 הזהות זהות בזהות noun feminine singular absolute unspecified unspecified  	O	null
3 ה ה היהודית definiteArticle unspecified unspecified unspecified unspecified unspecified 0 
3 היהודית יהודי היהודית adjective feminine singular absolute unspecified unspecified  	O	null
4 - - - punctuation unspecified unspecified unspecified unspecified unspecified  	O	null
5 ישראלית ישראלי ישראלית adjective feminine singular absolute unspecified unspecified  	O	null
6 של של של shel-preposition unspecified unspecified unspecified unspecified unspecified  	O	null
7 דמויות דמות דמויות noun feminine plural absolute unspecified unspecified  	O	null
8 עגומות עגום עגומות adjective feminine plural absolute unspecified unspecified  	O	null
9 ב ב בעלות preposition unspecified unspecified unspecified unspecified unspecified 0 
9 עלות עלות בעלות noun feminine singular construct unspecified unspecified  	O	null
10 עולם עולם עולם noun masculine singular absolute unspecified unspecified  	O	null
11 פנימי פנימי פנימי adjective masculine singular absolute unspecified unspecified  	O	null
12 מורכב מורכב מורכב adjective masculine singular absolute unspecified unspecified  	O	null
13 , , , punctuation unspecified unspecified unspecified unspecified unspecified  	O	null
14 ה ה המדשדשות definiteArticle unspecified unspecified unspecified unspecified unspecified 0 
14 המדשדשות דשדש המדשדשות participle feminine plural absolute any unspecified  	O	null
15 ב ב בפינותיו preposition unspecified unspecified unspecified unspecified unspecified 0 
15 פינות פינה בפינותיו noun feminine plural absolute unspecified unspecified  
15 ו ו בפינותיו possessive masculine singular unspecified 3 unspecified 0 	O	null
16 ה ה הנידחות definiteArticle unspecified unspecified unspecified unspecified unspecified 0 
16 הנידחות נידח הנידחות adjective feminine plural absolute unspecified unspecified  	O	null
17 של של של shel-preposition unspecified unspecified unspecified unspecified unspecified  	O	null
18 ה ה הקיום definiteArticle unspecified unspecified unspecified unspecified unspecified 0 
18 הקיום קיום הקיום noun masculine singular absolute unspecified unspecified  	O	null
19 ה ה האנושי definiteArticle unspecified unspecified unspecified unspecified unspecified 0 
19 האנושי אנושי האנושי adjective masculine singular absolute unspecified unspecified  	O	null
20 . . . punctuation unspecified unspecified unspecified unspecified unspecified  	O	null

0 הללו הללו הללו pronoun masculine plural unspecified 3 unspecified  	O	null
1 נקרעות נקרע נקרעות verb feminine plural unspecified any beinoni  	O	null
2 בין בין בין preposition unspecified unspecified unspecified unspecified unspecified  	O	null
3 מאמצי מאמץ מאמציהן noun masculine plural absolute unspecified unspecified  
3 הן הן מאמציהן possessive feminine plural unspecified 3 unspecified 0 	O	null
4 לעמוד עמד לעמוד verb unspecified unspecified unspecified unspecified infinitive  	O	null
5 ב ב בתביעה preposition unspecified unspecified unspecified unspecified unspecified 0 
5 ה ה בתביעה definiteArticle unspecified unspecified unspecified unspecified unspecified 0 
5 התביעה תביעה בתביעה noun feminine singular absolute unspecified unspecified  	O	null
6 לשאת נשא לשאת verb unspecified unspecified unspecified unspecified infinitive  	O	null
7 ב ב בנטל preposition unspecified unspecified unspecified unspecified unspecified 0 
7 נטל נטל בנטל noun masculine singular construct unspecified unspecified  	O	null
8 ה ה הזיכרון definiteArticle unspecified unspecified unspecified unspecified unspecified 0 
8 הזיכרון זיכרון הזיכרון noun masculine singular absolute unspecified unspecified  	O	null
9 ה ה הלאומי definiteArticle unspecified unspecified unspecified unspecified unspecified 0 
9 הלאומי לאומי הלאומי adjective masculine singular absolute unspecified unspecified  	O	null
10 , , , punctuation unspecified unspecified unspecified unspecified unspecified  	O	null
11 לבין לבין לבין preposition unspecified unspecified unspecified unspecified unspecified  	O	null
12 ניסיונותי ניסיון ניסיונותיהן noun masculine plural absolute unspecified unspecified  
12 הן הן ניסיונותיהן possessive feminine plural unspecified 3 unspecified 0 	O	null
13 לשרוד שרד לשרוד verb unspecified unspecified unspecified unspecified infinitive  	O	null
14 כ כ כיחידים preposition unspecified unspecified unspecified unspecified unspecified 0 
14 ה ה כיחידים definiteArticle unspecified unspecified unspecified unspecified unspecified 0 
14 היחידים יחיד כיחידים adjective masculine plural absolute unspecified unspecified  	O	null
15 ה ה המשוחררים definiteArticle unspecified unspecified unspecified unspecified unspecified 0 
15 המשוחררים משוחרר המשוחררים adjective masculine plural absolute unspecified unspecified  	O	null
16 מ מ מכבלי preposition unspecified unspecified unspecified unspecified unspecified 0 
16 כבלי כבל מכבלי noun masculine plural construct unspecified unspecified  	O	null
17 ה ה החברה definiteArticle unspecified unspecified unspecified unspecified unspecified 0 
17 החברה חבר החברה noun feminine singular absolute unspecified unspecified  	O	null
18 . . . punctuation unspecified unspecified unspecified unspecified unspecified  	O	null

0 ב ב בנימה preposition unspecified unspecified unspecified unspecified unspecified 0 
0 נימה נימה בנימה noun feminine singular absolute unspecified unspecified  	O	null
1 מהורהרת מהורהר מהורהרת adjective feminine singular absolute unspecified unspecified  	O	null
2 ו ו ונוגה conjunction unspecified unspecified unspecified unspecified unspecified 0 
2 נוגה נוגה ונוגה adjective feminine singular absolute unspecified unspecified  	O	null
3 משורטטת שורטט משורטטת participle feminine singular construct any unspecified  	O	null
4 ה ה הווייתם definiteArticle unspecified unspecified unspecified unspecified unspecified 0 
4 הווייתם הווייתם הווייתם noun masculine plural absolute unspecified unspecified  	O	null
5 של של של shel-preposition unspecified unspecified unspecified unspecified unspecified  	O	null
6 אנשים איש אנשים noun masculine plural absolute unspecified unspecified  	O	null
7 תלושים תלוש תלושים adjective masculine plural absolute unspecified unspecified  	O	null
8 , , , punctuation unspecified unspecified unspecified unspecified unspecified  	O	null
9 ה ה השקועים definiteArticle unspecified unspecified unspecified unspecified unspecified 0 
9 השקועים שקוע השקועים adjective masculine plural absolute unspecified unspecified  	O	null
10 ב ב בקיום preposition unspecified unspecified unspecified unspecified unspecified 0 
10 קיום קיום בקיום noun masculine singular absolute unspecified unspecified  	O	null
11 חברתי חברתי חברתי adjective masculine singular absolute unspecified unspecified  	O	null
12 כושל כשל כושל verb masculine singular unspecified any beinoni  	O	null
13 ו ו ובמצב conjunction unspecified unspecified unspecified unspecified unspecified 0 
13 ב ב ובמצב preposition unspecified unspecified unspecified unspecified unspecified 0 
13 מצב מצב ובמצב noun masculine singular absolute unspecified unspecified  	O	null
14 תמידי תמידי תמידי adjective masculine singular absolute unspecified unspecified  	O	null
15 של של של shel-preposition unspecified unspecified unspecified unspecified unspecified  	O	null
16 בריחה בריחה בריחה noun feminine singular absolute unspecified unspecified  	O	null
17 מעבר מעבר מעבר noun masculine singular absolute unspecified unspecified  	O	null
18 מטריד מטריד מטריד adjective masculine singular absolute unspecified unspecified  	O	null
19 או או או conjunction unspecified unspecified unspecified unspecified unspecified  	O	null
20 ב ב בציפייה preposition unspecified unspecified unspecified unspecified unspecified 0 
20 ציפייה ציפייה בציפייה noun feminine singular absolute unspecified unspecified  	O	null
21 ל ל לשובם preposition unspecified unspecified unspecified unspecified unspecified 0 
21 שוב שוב לשובם noun masculine singular absolute unspecified unspecified  
21 ם ם לשובם possessive masculine plural unspecified 3 unspecified 0 	O	null
22 של של של shel-preposition unspecified unspecified unspecified unspecified unspecified  	O	null
23 ימים יום ימים noun masculine plural absolute unspecified unspecified  	O	null
24 טובים טוב טובים adjective masculine plural absolute unspecified unspecified  	O	null
25 . . . punctuation unspecified unspecified unspecified unspecified unspecified  	O	null

0 ה ה הקושי definiteArticle unspecified unspecified unspecified unspecified unspecified 0 
0 הקושי קושי הקושי noun masculine singular absolute unspecified unspecified  	O	null
1 להשתלב השתלב להשתלב verb unspecified unspecified unspecified unspecified infinitive  	O	null
2 ב ב בחברה preposition unspecified unspecified unspecified unspecified unspecified 0 
2 ה ה בחברה definiteArticle unspecified unspecified unspecified unspecified unspecified 0 
2 החברה חבר בחברה noun feminine singular absolute unspecified unspecified  	O	null
3 מתבטא התבטא מתבטא verb masculine singular unspecified any beinoni  	O	null
4 ב ב באורח preposition unspecified unspecified unspecified unspecified unspecified 0 
4 אורח אורח באורח noun masculine singular construct unspecified unspecified  	O	null
5 חיים חיים חיים noun masculine plural absolute unspecified unspecified  	O	null
6 של של של shel-preposition unspecified unspecified unspecified unspecified unspecified  	O	null
7 אפרוריות אפרוריות אפרוריות noun feminine singular absolute unspecified unspecified  	O	null
8 ו ו ובדידות conjunction unspecified unspecified unspecified unspecified unspecified 0 
8 בדידות בדידות ובדידות noun feminine singular absolute unspecified unspecified  	O	null
9 , , , punctuation unspecified unspecified unspecified unspecified unspecified  	O	null
10 ש ש שעל relativizer/subordinatingConjunction unspecified unspecified unspecified unspecified unspecified 0 
10 על על שעל preposition unspecified unspecified unspecified unspecified unspecified  	O	null
11 רקע רקע רקעו noun masculine singular absolute unspecified unspecified  
11 ו ו רקעו possessive masculine singular unspecified 3 unspecified 0 	O	null
12 בולטת בלט בולטת verb feminine singular unspecified any beinoni  	O	null
13 ה ה הכמיהה definiteArticle unspecified unspecified unspecified unspecified unspecified 0 
13 הכמיהה כמיהה הכמיהה noun feminine singular absolute unspecified unspecified  	O	null
14 ל ל לשינוי preposition unspecified unspecified unspecified unspecified unspecified 0 
14 שינוי שינוי לשינוי noun masculine singular absolute unspecified unspecified  	O	null
15 ו ו ולחיפוש conjunction unspecified unspecified unspecified unspecified unspecified 0 
15 ל ל ולחיפוש preposition unspecified unspecified unspecified unspecified unspecified 0 
15 חיפוש חיפוש ולחיפוש noun masculine singular construct unspecified unspecified  	O	null
16 נחמה נחמה נחמה properName unspecified unspecified unspecified unspecified unspecified  	I_PERS	null
17 . . . punctuation unspecified unspecified unspecified unspecified unspecified  	O	null

0 אלה אלה אלה pronoun masculine-and-feminine plural unspecified 3 unspecified  	O	null
1 מופיעים הופיע מופיעים verb masculine plural unspecified any beinoni  	O	null
2 לעתים לעתים לעתים adverb unspecified unspecified unspecified unspecified unspecified  	O	null
3 ב ב בדרך preposition unspecified unspecified unspecified unspecified unspecified 0 
3 דרך דרך בדרך noun feminine singular absolute unspecified unspecified  	O	null
4 של של של shel-preposition unspecified unspecified unspecified unspecified unspecified  	O	null
5 מפגש מפגש מפגש noun masculine singular absolute unspecified unspecified  	O	null
6 , , , punctuation unspecified unspecified unspecified unspecified unspecified  	O	null
7 ל ל לרוב preposition unspecified unspecified unspecified unspecified unspecified 0 
7 רוב רוב לרוב noun masculine singular absolute unspecified unspecified  	O	null
8 מאכזב מאכזב מאכזב adjective masculine singular absolute unspecified unspecified  	O	null
9 , , , punctuation unspecified unspecified unspecified unspecified unspecified  	O	null
10 עם עם עם preposition unspecified unspecified unspecified unspecified unspecified  	O	null
11 ה ה האחר definiteArticle unspecified unspecified unspecified unspecified unspecified 0 
11 האחר אחר האחר adjective masculine singular absolute unspecified unspecified  	O	null
12 , , , punctuation unspecified unspecified unspecified unspecified unspecified  	O	null
13 על על על preposition unspecified unspecified unspecified unspecified unspecified  	O	null
14 רקע רקע רקע noun masculine singular construct unspecified unspecified  	O	null
15 נופי נוף נופי noun masculine plural construct unspecified unspecified  	O	null
16 ישראל ישראל ישראל properName unspecified unspecified unspecified unspecified unspecified  	I_LOC	null
17 מוכת מוכה מוכת adjective feminine singular construct unspecified unspecified  	O	null
18 ה ה החמסין definiteArticle unspecified unspecified unspecified unspecified unspecified 0 
18 החמסין חמסין החמסין noun masculine singular absolute unspecified unspecified  	O	null
19 . . . punctuation unspecified unspecified unspecified unspecified unspecified  	O	null

0 ארבל ארבל ארבל properName unspecified unspecified unspecified unspecified unspecified  	I_PERS	null
1 , , , punctuation unspecified unspecified unspecified unspecified unspecified  	O	null
2 טל טל טל properName unspecified unspecified unspecified unspecified unspecified  	I_PERS	null
3 . . . punctuation unspecified unspecified unspecified unspecified unspecified  	O	null

0 " " " punctuation unspecified unspecified unspecified unspecified unspecified  	O	null
1 כמיהה כמיהה כמיהה noun feminine singular absolute unspecified unspecified  	O	null
2 , , , punctuation unspecified unspecified unspecified unspecified unspecified  	O	null
3 בדידות בדידות בדידות noun feminine singular absolute unspecified unspecified  	O	null
4 , , , punctuation unspecified unspecified unspecified unspecified unspecified  	O	null
5 חרטה חרטה חרטה noun feminine singular absolute unspecified unspecified  	O	null
6 ו ו ורצון conjunction unspecified unspecified unspecified unspecified unspecified 0 
6 רצון רצון ורצון noun masculine singular absolute unspecified unspecified  	O	null
7 ב ב בנחמה preposition unspecified unspecified unspecified unspecified unspecified 0 
7 נחמה נחמה בנחמה noun feminine singular absolute unspecified unspecified  	O	null
8 " " " punctuation unspecified unspecified unspecified unspecified unspecified  	O	null
9 . . . punctuation unspecified unspecified unspecified unspecified unspecified  	O	null

0 ה ה הארץ definiteArticle unspecified unspecified unspecified unspecified unspecified 0 
0 הארץ ארץ הארץ noun feminine singular absolute unspecified unspecified  	O	null
1 ספרים ספר ספרים noun masculine plural absolute unspecified unspecified  	O	null
2 . . . punctuation unspecified unspecified unspecified unspecified unspecified  	O	null

0 ###NUMEXP### ###NUMEXP### ###NUMEXP### numberExpression unspecified unspecified unspecified unspecified unspecified  	I_DATE	null
1 . . . punctuation unspecified unspecified unspecified unspecified unspecified  	O	null

0 ; ; ; punctuation unspecified unspecified unspecified unspecified unspecified  	O	null
1 ###NUMBER### ###NUMBER### ###NUMBER### numeral unspecified unspecified unspecified unspecified unspecified  	O	null
2 הרצוג הרצוג הרצוג properName unspecified unspecified unspecified unspecified unspecified  	I_PERS	null
3 , , , punctuation unspecified unspecified unspecified unspecified unspecified  	O	null
4 עמרי עמרי עמרי properName unspecified unspecified unspecified unspecified unspecified  	I_PERS	null
5 . . . punctuation unspecified unspecified unspecified unspecified unspecified  	O	null

0 " " " punctuation unspecified unspecified unspecified unspecified unspecified  	I_ORG	null
1 נחמיאס-גלס-חמסין נחמיאס-גלס-חמסין נחמיאס-גלס-חמסין properName unspecified unspecified unspecified unspecified unspecified  	I_ORG	null
2 " " " punctuation unspecified unspecified unspecified unspecified unspecified  	O	null
3 . . . punctuation unspecified unspecified unspecified unspecified unspecified  	O	null

0 ה ה הארץ definiteArticle unspecified unspecified unspecified unspecified unspecified 0 
0 הארץ ארץ הארץ noun feminine singular absolute unspecified unspecified  	O	null
1 תרבות תרבות תרבות noun feminine singular absolute unspecified unspecified  	O	null
2 ו ו וספרות conjunction unspecified unspecified unspecified unspecified unspecified 0 
2 ספרות ספרות וספרות noun feminine singular absolute unspecified unspecified  	O	null
3 . . . punctuation unspecified unspecified unspecified unspecified unspecified  	O	null

0 ###NUMEXP### ###NUMEXP### ###NUMEXP### numberExpression unspecified unspecified unspecified unspecified unspecified  	I_DATE	null
1 . . . punctuation unspecified unspecified unspecified unspecified unspecified  	O	null

0 ; ; ; punctuation unspecified unspecified unspecified unspecified unspecified  	O	null
1 ###NUMBER### ###NUMBER### ###NUMBER### numeral unspecified unspecified unspecified unspecified unspecified  	O	null
2 קדוש קדוש קדוש properName unspecified unspecified unspecified unspecified unspecified  	I_PERS	null
3 , , , punctuation unspecified unspecified unspecified unspecified unspecified  	O	null
4 אורנה אורנה אורנה properName unspecified unspecified unspecified unspecified unspecified  	I_PERS	null
5 . . . punctuation unspecified unspecified unspecified unspecified unspecified  	O	null

0 " " " punctuation unspecified unspecified unspecified unspecified unspecified  	O	null
1 ה ה המשורר definiteArticle unspecified unspecified unspecified unspecified unspecified 0 
1 המשורר משורר המשורר noun masculine singular absolute unspecified unspecified  	O	null
2 ה ה הלאומי definiteArticle unspecified unspecified unspecified unspecified unspecified 0 
2 הלאומי לאומי הלאומי adjective masculine singular absolute unspecified unspecified  	O	null
3 " " " punctuation unspecified unspecified unspecified unspecified unspecified  	O	null
4 . . . punctuation unspecified unspecified unspecified unspecified unspecified  	O	null

0 מעריב מעריב מעריב properName unspecified unspecified unspecified unspecified unspecified  	I_ORG	null
1 סופשבוע סופשבוע סופשבוע properName unspecified unspecified unspecified unspecified unspecified  	I_ORG	null
2 . . . punctuation unspecified unspecified unspecified unspecified unspecified  	O	null

0 ###NUMEXP### ###NUMEXP### ###NUMEXP### numberExpression unspecified unspecified unspecified unspecified unspecified  	I_DATE	null
1 . . . punctuation unspecified unspecified unspecified unspecified unspecified  	O	null

0 ###NUMBER### ###NUMBER### ###NUMBER### numeral unspecified unspecified unspecified unspecified unspecified  	O	null
1 - - - punctuation unspecified unspecified unspecified unspecified unspecified  	O	null
2 ###NUMBER### ###NUMBER### ###NUMBER### numeral unspecified unspecified unspecified unspecified unspecified  	O	null
3 . . . punctuation unspecified unspecified unspecified unspecified unspecified  	O	null

0 יובל יובל יובל properName unspecified unspecified unspecified unspecified unspecified  	I_PERS	null
1 פז פז פז properName unspecified unspecified unspecified unspecified unspecified  	I_PERS	null

